3 3 3 3 3 3 3 3 3 3 3 3 3 3 3 3 14 5 5 5 5 5 5 5 5 5 15 3 3 3 3 3 3 14 5 5 5 5 5 5 5 5 5 5 5 15 3 3 3 3
3 3 3 3 3 3 3 3 3 3 3 3 3 3 3 3 8 0 2 0 0 2 0 0 0 0 9 3 3 3 3 3 3 8 0 0 0 0 0 0 0 0 0 0 0 9 3 3 3 3
3 3 3 3 3 3 3 3 3 3 3 3 3 3 3 3 8 0 0 2 0 0 2 0 0 2 9 3 3 3 3 3 3 8 0 0 0 0 0 0 0 0 0 0 0 9 3 3 3 3
3 3 3 3 14 5 5 5 5 5 5 5 5 5 5 5 12 0 0 0 0 0 0 0 0 0 11 5 5 5 5 5 5 12 0 0 0 0 0 0 0 0 0 0 0 0 3 3 3 3 
3 3 3 3 8 0 0 2 0 2 0 0 0 0 0 2 0 0 2 0 0 0 0 2 0 0 0 2 0 0 2 0 0 0 2 0 0 2 0 0 0 2 0 0 0 2 9 3 3 3 
3 3 3 3 8 0 2 0 0 2 0 2 0 0 2 2 0 2 0 2 0 2 0 2 0 2 0 0 2 0 2 0 2 0 2 0 2 0 2 0 2 0 0 2 0 2 9 3 3 3
3 3 3 3 8 0 0 2 0 0 2 0 0 2 0 0 0 0 2 0 0 0 0 2 0 0 0 2 0 0 0 0 2 0 0 0 2 0 2 0 2 0 2 0 2 0 9 3 3 3
3 3 3 3 8 2 0 0 2 0 0 2 0 2 0 0 2 0 0 0 2 0 2 0 0 2 0 0 0 2 0 2 0 0 0 2 0 0 0 2 0 0 0 0 0 0 9 3 3 3
3 3 14 5 12 0 0 2 0 2 0 0 0 0 0 2 0 0 2 0 0 0 0 2 0 0 0 2 0 0 2 0 0 0 2 0 0 2 0 0 0 2 0 0 0 9 3 3 3 3 
3 3 8 0 2 0 2 0 0 2 0 2 0 0 2 2 0 2 0 2 0 2 0 2 0 2 0 0 2 0 2 0 2 0 2 0 2 0 2 0 2 0 0 2 0 2 9 3 3 3
3 3 8 2 0 0 0 2 0 0 2 0 0 2 0 0 0 0 2 0 0 0 0 2 0 0 0 2 0 0 0 0 2 0 0 0 2 0 2 0 2 0 2 0 2 0 9 3 3 3
3 3 8 0 0 2 0 0 2 0 0 2 0 2 0 0 2 0 0 0 2 0 2 0 0 2 0 0 0 2 0 2 0 0 0 2 0 0 0 2 0 0 0 0 0 0 9 3 3 3
3 3 8 0 2 0 0 2 0 2 0 0 0 0 0 2 0 0 2 0 0 0 0 2 0 0 0 2 0 0 2 0 0 0 2 0 0 2 0 0 0 2 0 0 0 2 9 3 3 3
3 3 8 0 2 0 2 0 0 2 0 2 0 0 2 2 0 2 0 2 0 2 0 2 0 2 0 0 2 0 2 0 2 0 2 0 2 0 2 0 2 0 0 2 0 2 9 3 3 3
3 3 8 2 0 0 0 2 0 0 2 0 0 2 0 0 0 0 2 0 0 0 0 2 0 0 0 2 0 0 0 0 2 0 0 0 2 0 2 0 2 0 2 0 2 0 9 3 3 3
3 3 8 0 0 2 0 0 2 0 0 2 0 2 0 0 2 0 0 0 2 0 2 0 0 2 0 0 0 2 0 2 0 0 0 2 0 0 0 2 0 0 0 0 0 0 9 3 3 3
3 3 8 0 2 0 0 2 0 2 0 0 0 0 0 2 0 0 2 0 0 0 0 2 0 0 0 2 0 0 2 0 0 0 2 0 0 2 0 0 0 2 0 0 0 2 9 3 3 3
3 3 8 0 2 0 2 0 0 2 0 2 0 0 2 2 0 2 0 2 0 2 0 2 0 2 0 0 2 0 2 0 2 0 2 0 2 0 2 0 2 0 0 2 0 2 9 3 3 3
3 3 8 2 0 0 0 2 0 0 2 0 0 2 0 0 0 0 2 0 0 0 0 2 0 0 0 2 0 0 0 0 2 0 0 0 2 0 2 0 2 0 2 0 2 0 9 3 3 3
3 3 8 0 0 2 0 0 2 0 0 2 0 2 0 0 2 0 0 0 2 0 2 0 0 2 0 0 0 2 0 2 0 0 0 2 0 0 0 2 0 0 0 0 0 0 9 3 3 3
3 3 8 0 2 0 0 2 0 2 0 0 0 0 0 2 0 0 2 0 0 0 0 2 0 0 0 2 0 0 2 0 0 0 2 0 0 2 0 0 0 2 0 0 0 2 9 3 3 3
3 3 8 0 2 0 2 0 0 2 0 2 0 0 2 2 0 2 0 2 0 2 0 2 0 2 0 0 2 0 2 0 2 0 2 0 2 0 2 0 2 0 0 2 0 2 9 3 3 3
3 3 8 2 0 0 0 2 0 0 2 0 0 2 0 0 0 0 2 0 0 0 0 2 0 0 0 2 0 0 0 0 2 0 0 0 2 0 2 0 2 0 2 0 2 0 9 3 3 3
3 3 8 0 0 2 0 0 2 0 0 2 0 2 0 0 2 0 0 0 2 0 2 0 0 2 0 0 0 2 0 2 0 0 0 2 0 0 0 2 0 0 0 0 0 0 9 3 3 3
3 3 8 0 2 0 0 2 0 2 0 0 0 0 0 2 0 0 2 0 0 0 0 2 0 0 0 2 0 0 2 0 0 0 2 0 0 2 0 0 0 2 0 0 0 2 9 3 3 3
3 3 8 0 2 0 2 0 0 2 0 2 0 0 2 2 0 2 0 2 0 2 0 2 0 2 0 0 2 0 2 0 2 0 2 0 2 0 2 0 2 0 0 2 0 2 9 3 3 3
3 3 8 2 0 0 0 2 0 0 2 0 0 2 0 0 0 0 2 0 0 0 0 2 0 0 0 2 0 0 0 0 2 0 0 0 2 0 2 0 2 0 2 0 2 0 9 3 3 3
3 3 8 0 0 2 0 0 2 0 0 2 0 2 0 0 2 0 0 0 2 0 2 0 0 2 0 0 0 2 0 2 0 0 0 2 0 0 0 2 0 0 0 0 0 0 9 3 3 3
3 3 8 0 2 0 0 2 0 2 0 0 0 0 0 2 0 0 2 0 0 0 0 2 0 0 0 2 0 0 2 0 0 0 2 0 0 2 0 0 0 2 0 0 0 2 9 3 3 3
3 3 8 0 2 0 2 0 0 2 0 2 0 0 2 2 0 2 0 2 0 2 0 2 0 2 0 0 2 0 2 0 2 0 2 0 2 0 2 0 2 0 0 2 0 2 9 3 3 3
3 3 8 2 0 0 0 2 0 0 2 0 0 2 0 0 0 0 2 0 0 0 0 2 0 0 0 2 0 0 0 0 2 0 0 0 2 0 2 0 2 0 2 0 2 0 9 3 3 3
3 3 8 0 0 2 0 0 2 0 0 2 0 2 0 0 2 0 0 0 2 0 2 0 0 2 0 0 0 2 0 2 0 0 0 2 0 0 0 2 0 0 0 0 0 0 9 3 3 3
3 3 8 0 2 0 0 2 0 2 0 0 0 0 0 2 0 0 2 0 0 0 0 2 0 0 0 2 0 0 2 0 0 0 2 0 0 2 0 0 0 2 0 0 0 2 9 3 3 3
3 3 8 0 2 0 2 0 0 2 0 2 0 0 2 2 0 2 0 2 0 2 0 2 0 2 0 0 2 0 2 0 2 0 2 0 2 0 2 0 2 0 0 2 0 2 9 3 3 3
3 3 8 2 0 0 0 2 0 0 2 0 0 2 0 0 0 0 2 0 0 0 0 2 0 0 0 2 0 0 0 0 2 0 0 0 2 0 2 0 2 0 2 0 2 0 9 3 3 3
3 3 8 0 0 2 0 0 2 0 0 2 0 2 0 0 2 0 0 0 2 0 2 0 0 2 0 0 0 2 0 2 0 0 0 2 0 0 0 2 0 0 0 0 0 0 9 3 3 3
3 3 8 0 2 0 0 2 0 2 0 0 0 0 0 2 0 0 2 0 0 0 0 2 0 0 0 2 0 0 2 0 0 0 2 0 0 2 0 0 0 2 0 0 0 2 9 3 3 3
3 3 8 0 2 0 2 0 0 2 0 2 0 0 2 2 0 2 0 2 0 2 0 2 0 2 0 0 2 0 2 0 2 0 2 0 2 0 2 0 2 0 0 2 0 2 9 3 3 3
3 3 8 2 0 0 0 2 0 0 2 0 0 2 0 0 0 0 2 0 0 0 0 2 0 0 0 2 0 0 0 0 2 0 0 0 2 0 2 0 2 0 2 0 2 0 9 3 3 3
3 3 8 0 0 2 0 0 2 0 0 2 0 2 0 0 2 0 0 0 2 0 2 0 0 2 0 0 0 2 0 2 0 0 0 2 0 0 0 2 0 0 0 0 0 0 9 3 3 3
3 3 8 0 2 0 0 2 0 2 0 0 0 0 0 2 0 0 2 0 0 0 0 2 0 0 0 2 0 0 2 0 0 0 2 0 0 2 0 0 0 2 0 0 0 2 9 3 3 3
3 3 8 0 2 0 2 0 0 2 0 2 0 0 2 2 0 2 0 2 0 2 0 2 0 2 0 0 2 0 2 0 2 0 2 0 2 0 2 0 2 0 0 2 0 2 9 3 3 3
3 3 8 2 0 0 0 2 0 0 2 0 0 2 0 0 0 0 2 0 0 0 0 2 0 0 0 2 0 0 0 0 2 0 0 0 2 0 2 0 2 0 2 0 2 0 9 3 3 3
3 3 8 0 0 2 0 0 2 0 0 2 0 2 0 0 2 0 0 0 2 0 2 0 0 2 0 0 0 2 0 2 0 0 0 2 0 0 0 2 0 0 0 0 0 0 9 3 3 3
3 3 13 1 1 1 1 1 2 0 2 0 0 0 0 0 2 0 0 2 0 0 0 0 2 0 0 0 2 0 0 2 0 0 0 2 0 0 2 0 0 0 2 0 0 0 9 3 3 3 
3 3 3 0 2 0 2 0 0 2 0 2 0 0 2 2 0 2 0 2 0 2 0 2 0 2 0 0 2 0 2 0 2 0 2 0 2 0 2 0 2 0 0 2 0 2 9 3 3 3
3 3 3 2 0 0 0 2 0 0 2 0 0 2 0 0 0 0 2 0 0 0 0 2 0 0 0 2 0 0 0 0 2 0 0 0 2 0 2 0 2 0 2 0 2 0 9 3 3 3
3 3 3 0 0 2 0 0 2 0 0 2 0 2 0 0 2 0 0 0 2 0 2 0 0 2 0 0 0 2 0 2 0 0 0 2 0 0 0 2 0 0 0 0 0 0 9 3 3 3
3 3 3 0 2 0 0 2 0 2 0 0 0 0 0 2 0 0 2 0 0 0 0 2 0 0 0 2 0 0 2 0 0 0 2 0 0 2 0 0 0 2 0 0 0 2 9 3 3 3
3 3 3 1 1 1 1 1 1 1 1 1 1 1 1 1 1 1 1 1 1 1 1 1 1 1 1 1 1 1 1 1 1 1 1 1 1 1 1 1 1 1 1 1 1 1 3 3 3 3
